111111111111111
10P100000C00001
101101011010001
100101001000001
100C00001110001
100000000000001
100000000000001
100000000000001
100000000000001
100000000000001
100000000000001
100000000000001
100000000000001
100000000000001
100000000000001
100000000000001
100100100001101
101101011110001
10E100100001101
101101011110001
100100100001101
101101011110001
100100100001101
101111011111001
100000000001101
111111111111111
