111111111111111
10P100000C00001
101101011010001
100101001000001
100C00001110001
101101011110001
100100100001101
100100111110001
100C01000000101
111101101100001
100001000001001
101111001101001
100001001000001
100111111011101
101000000001001
100111110001001
100000000011101
111101101101001
100100000100001
101101111110001
100001001000001
101111001111101
100001001000001
100111111110001
100000000100001
101110101101001
100001000001001
101111001110001
100000E10000001
101111011111001
100000000001101
111111111111111
