1111111
1P0C001
1011001
1001001
100C001
1011001
1001001
1011001
10E1001
1001001
1011001
1001001
1011001
1001001
1011001
1001001
1011001
1001001
1011001
1001001
1011001
1001001
1011001
1001001
1011001
1001001
1011001
1001001
1011001
1001001
1011001
1001001
1011001
1001001
1011001
1001001
1011001
1001001
1011001
1001001
1011001
1001001
1011001
1001001
1011001
1001001
1011001
1001001
1011001
1001001
1011001
1001001
1011001
1111111
