111111111111111
100C00000C00001
101100000000001
10P1E0000000001
111111111111111
