1111111
100CP01
1011001
10P1E01
1111111
