111111
100001
1PC0A1
100111
1C1111
1000E1
100001
111111
