111111
100001
1PC00
100111
1C1111
1000E1
100001
111111
