11111
1P0C1
10E01
10001
11111
