1111111
1000001
101C001
10P0E01
1111111
