1111111
100C001
1011001
10P1E01
1111111
